############################################################
#................................................###########
#.o..............................................###########
#................................................###########
#................................................###########
#~~~~~~~~~~~~~~~~~~~~~...~~~~~~~~~~~~~~~~~~~~~~~~###########
#~~~~~~~~~~~~~~~~~~~~~...~~~~~~~~~~~~~~~~~~~~~~~~###########
#~~~~~~~~~~~~~~~~~~~~~...~~~~~~~~~~~~~~~~~~~~~~~~###########
#........................=.......................###########
#........$........................$..............###########
#..$...........$.................................###########
#.........................^......................###########
#...................^............................###########
#........................^...^...................###########
#................................................###########
#................................................###########
#................................................###########
#......^.........................................###########
#...............................................L###########
############################################################
############################################################
############################################################
############################################################
############################################################
############################################################
###################################........................P
###################################........................#
###################################........................#
############################################################
############################################################
############################################################
############################################################
