##################################################
#................................................#
#.o..............................................#
#................................................#
#................................................#
#~~~~~~~~~~~~~~~~~~~~~...~~~~~~~~~~~~~~~~~~~~~~~~#
#~~~~~~~~~~~~~~~~~~~~~...~~~~~~~~~~~~~~~~~~~~~~~~#
#~~~~~~~~~~~~~~~~~~~~~...~~~~~~~~~~~~~~~~~~~~~~~~#
#........................=.......................#
#........$........................$..............#
#..$...........$.................................#
#.........................^......................#
#...................^............................#
#........................^...^...................#
#................................................#
#................................................#
#................................................#
#......^.........................................#
#...............................................L#
##################################################